########################
#                      #
#  S                   #
#                      #
#      ####    ####    #
#      #        #      #
#                      #
#                      #
#      #        #      #
#      ####    ####    #
#                      #
#                      #
#                      #
#                      #
#      ####    ####    #
#      #        #      #
#                      #
#                      #
#      #        #      #
#      ####    ####    #
#                   S  #
#                      #
########################
